+--+--+--+--+
|           |
+--+--+  +--+
|     |  |  |
+  +  +  +  +
|  |  |  |  |
+  +--+  +  +
|           |
+--+--+--+--+