+--+--+--+--+--+--+--+--+--+--+--+--+--+--+--+--+--+--+--+--+
                  |        |  |                 |        |  |
+--+--+  +--+--+  +  +--+  +  +--+--+  +--+--+  +  +--+  +  +
|     |  |  |     |  |     |  |     |  |  |     |  |     |  |
+  +  +  +  +  +--+--+  +--+  +  +  +  +  +  +--+--+  +--+  +
|  |  |  |  |        |     |  |  |  |  |  |        |     |  |
+  +--+  +  +--+--+  +  +  +  +  +--+  +  +--+--+  +  +  +  +
|           |     |     |     |           |     |     |     |
+--+--+  +--+  +  +--+--+--+  +--+--+  +--+  +  +--+--+--+  +
|     |     |  |  |        |  |     |     |  |  |        |  |
+  +  +  +  +  +  +  +--+  +  +  +  +  +  +  +  +  +--+  +  +
|  |     |  |  |     |     |  |  |     |  |  |     |     |  |
+  +--+--+  +  +--+--+  +--+  +  +--+--+--+  +--+--+  +  +  +
|        |     |  |     |     |        |     |  |     |     |
+--+--+  +--+--+  +  +--+--+--+--+--+  +--+  +  +  +--+--+--+
|           |  |     |        |        |  |  |     |        |
+  +--+--+  +  +--+--+  +--+  +  +--+--+  +  +--+--+  +--+  +
|        |     |     |  |     |        |     |     |  |     |
+--+--+  +  +--+  +  +  +  +--+--+--+  +  +--+  +  +  +  +--+
|        |        |     |              |        |     |      
+--+--+--+--+--+--+--+--+--+--+--+--+--+--+--+--+--+--+--+--+