   ####################################################################################################################################################
            #     #        #  #        #     #  #     #           #                 #  #        #  #  #        #           #     #  #           #     #
#  #######  ####  #  ####  #  #  #  ####  #  #  #  #  ####  ##########  #  #  #######  #  ####  #  #  #  ####  #  ####  #######  #  #######  #######  #
#        #              #     #  #  #  #  #     #  #              #     #  #        #  #  #  #     #     #     #  #           #                 #  #  #
#  #######  #######  #  #  #  ####  #  #  #######  #  ######################  #  ####  #  #  ####  #######  #  #  #  #  #######  #  ####  ####  #  #  #
#        #     #     #  #  #  #     #        #     #           #              #     #  #     #     #        #  #  #  #  #  #  #  #  #        #     #  #
#  #  ####  ####  #############  #  #  #  #  #  #######  ####  #######  #  #######  #  #######  #  #  #  ####  ####  ####  #  #######  #  #  #######  #
#  #  #     #  #        #        #     #  #  #     #        #  #        #  #        #     #     #     #  #     #  #        #  #  #     #  #        #  #
####  ####  #  #  #  ##########  #  #  #  ###################  #############  ##########  ####  #  #############  #  ####  #  #  #  #  #############  #
#     #  #  #     #     #        #  #  #           #  #  #     #  #  #  #                 #  #  #  #     #  #     #     #     #     #  #     #     #  #
#  ####  #  #  #######  ####  #############  ####  #  #  #  ####  #  #  #  #######  ####  #  ####  #  #  #  #  ####  #######  #  ####  #  ####  ####  #
#  #  #  #  #  #     #  #  #  #     #  #     #     #  #           #        #     #     #  #        #  #                 #  #     #        #        #  #
####  #  #  #  #  #  #  #  ####  ####  #  ####  ####  #######  #######  #######  #  #  ####  ####  ####  ####  ####  #  #  #  #######  #  #  ####  #  #
#  #     #  #  #  #     #  #              #  #     #              #  #        #     #        #  #  #  #  #        #  #  #  #        #  #        #     #
#  #  ##########  #  ####  ##########  #  #  ####  #  #######  ####  #  #######  ####  #  ####  ####  #  ####  ####  ####  ###################  #######
#           #     #  #     #     #     #     #              #  #        #        #  #  #     #     #     #     #                 #  #     #           #
##########  #  #  #  #  #######  ####  ##########  #######  #############  #  ####  ####  #  #  #######  ##########  ##########  #  ####  #  #  #######
#              #  #  #  #     #     #  #              #           #        #  #     #     #     #              #  #           #     #     #  #     #  #
#  ####  #######  ####  #  #######  #############  #######  #  ####  #############  ####  ####  #  #  ##########  #######  #  #  #  #  #######  ####  #
#     #     #  #        #              #  #  #     #     #  #        #     #  #  #  #        #  #  #              #        #  #  #  #     #        #  #
####  #######  #######  ####  #  #  #  #  #  #######  ####  #######  #  ####  #  #  #  #  #############  #######  #  #  #############  #######  ####  #
#           #        #     #  #  #  #        #        #        #           #           #              #  #     #  #  #  #  #                 #        #
####  #######  #  #  #  #  #  ####  ####  #######  ####  ##########  ####  ##########  #  ####  #############  #######  #  #######  ####  #  ####  ####
#              #  #  #  #  #     #     #     #           #     #     #     #           #     #           #        #           #     #     #        #  #
#  ################  ####  #  ####  #######  #######  ####  ####  #  #  ####  ####  ####  ####  #  #############  #  #  #######  ##########  #######  #
#           #     #  #  #        #  #     #        #  #  #     #  #  #     #  #     #        #  #     #              #        #  #              #  #  #
####  #  ####  #  ####  #######  ####  #  #  ##########  #  #  #  ####  #  #  #######  #######  ##########  #######  #  ####  #  ##########  #  #  #  #
#  #  #        #  #     #              #  #        #     #  #        #  #  #     #     #           #  #           #  #  #     #  #     #     #     #  #
#  #######  #  #######  ####  ####  ################  #######  #######  ####  ####  ####  ####  #  #  #######  ##########  #######  #######  #######  #
#           #        #        #     #                    #     #  #     #  #  #  #  #        #  #        #  #     #        #              #  #        #
#############  #  #  #############  #  #############  #  #  #  #  #######  ####  #############  ####  #  #  #  ######################  #  #  #  #  ####
#        #     #  #     #        #  #  #     #        #  #  #  #              #  #        #  #     #  #  #              #     #        #  #     #  #  #
####  #############  ##########  #  #  ####  #######  #  ####  ####  ####  #  #  #######  #  ##########  ##########  ####  ##########  #  ####  ####  #
#        #     #           #     #     #        #     #  #     #     #  #  #  #                       #  #  #           #           #  #  #  #  #  #  #
####  ####  ####  #############  #  ####  ####  #  #######  ####  ####  #  ##########  ################  #  ####  #############  #  #  ####  ####  #  #
#  #     #        #        #  #     #     #                    #        #                 #     #  #  #  #  #        #     #     #     #              #
#  #  #  #######  #  #######  #  ####  #######  #  #######  ####  #  ##########  ####  #  #  ####  #  #  #  ####  #  ####  ####  ####  ####  ##########
#     #  #        #  #     #        #        #  #  #     #        #  #  #     #     #  #  #        #              #        #     #        #        #  #
####  #  #  ####  #  #  #  ##########  #  ####  ####  #######  #  ####  ####  ####  ####  ####  #  #  ##########  #######  #############  #  #  #  #  #
#     #     #  #  #     #  #     #  #  #  #     #     #     #  #  #           #  #  #  #  #  #  #     #  #     #        #     #        #     #  #  #  #
####  #  #  #  #  #  #######  ####  #######  ####  #######  #############  ####  #  #  #  #  #  #  #  #  #  ###################  #######  #  #  ####  #
#     #  #  #  #     #  #        #     #  #     #     #     #              #     #     #  #     #  #     #     #        #  #        #     #  #        #
####  ####  #  #######  ####  #######  #  #  ####  ####  ####  #######  #  ####  #  #  #######  #  #  #  #  #  #  #######  #  ####  #  #  #######  ####
#  #     #        #  #           #     #        #           #     #     #     #     #  #        #  #  #     #  #        #        #  #  #        #  #  #
#  #############  #  ####  #######  ################  #######  #######  ####  #  ####  #  #  #######  #  #  #  #######  ####  ####  #  #######  ####  #
#     #           #  #        #     #  #  #                 #     #     #  #        #  #  #        #  #  #  #  #     #     #  #  #        #  #  #  #  #
#  #  #######  #  #  ####  #  ####  #  #  #  #  #  ####  ####  #  #  ####  ###################  #  ##########  ####  #  #######  ##########  #  #  #  #
#  #        #  #     #     #                 #  #  #  #  #     #  #              #  #     #  #  #  #  #                 #           #  #              #
#  ####  ####  ####  ##########  #  #  ####  #  ####  #  ####  #######  ####  ####  #  ####  #  ####  #######  #######  ####  #######  #######  #  ####
#  #  #  #  #     #  #     #     #  #     #  #     #     #  #  #  #        #     #     #  #  #     #                 #           #     #  #     #  #  #
####  #  #  #######  ####  ####  #########################  #  #  #######  ##########  #  #  #############  ####  ################  ####  #  ####  #  #
#  #                 #           #  #  #  #           #           #  #  #  #  #     #     #           #        #        #        #        #  #        #
#  #  ####  ####  ##########  ####  #  #  ##########  ##########  #  #  #  #  ####  #  #  #  #  #  #  ##########  #######  ####  ####  #######  #######
#     #     #  #        #           #        #     #     #  #  #        #     #     #  #     #  #  #  #  #                    #        #  #  #  #     #
#############  #  ####  ##########  #  ##########  #  ####  #  #############  #  #  #  ##########  ####  #  ################  #  ####  #  #  #  #  #  #
#              #     #              #     #           #  #  #        #        #  #        #              #        #        #  #  #        #        #  #
#######  #  ####  #  ##########  #  #  #  #  ####  ####  #  #  #############  ##########  #######  #  ####  #  ####  ####  #  ##########  #######  ####
#        #        #     #     #  #  #  #  #  #  #  #  #     #        #        #           #     #  #        #     #  #  #  #     #  #        #        #
#######  #######  #######  #######  ####  ####  #  #  ####  ####  ##########  #######  #  #  #######  #######  #######  #  ####  #  #  #  ##########  #
#  #  #        #     #     #           #  #  #     #           #     #           #     #  #        #  #     #              #  #  #     #     #     #  #
#  #  #  #############  ####  #  #  ####  #  ####  #######  ####  #  ####  #######  ####  #  ####  #  ####  ####  #######  #  #######  #  #######  #  #
#     #        #  #     #     #  #                    #           #  #     #        #  #     #     #           #        #  #  #     #  #     #        #
#  #  ####  ####  ####  #  ####  #  #############  #  ####  #############  #  #  ####  #  #  #  #  ####  ##########  #  ####  ####  #  ##########  ####
#  #  #     #  #  #     #  #  #  #           #     #           #  #        #  #     #  #  #  #  #     #     #  #     #        #     #                 #
#  ####  ####  #  #  #######  #  ####  #  ###################  #  #  #  #############  #  #  #  ####  ####  #  #  ####  #  #  #  ####  #  #  ##########
#     #     #        #  #  #  #     #  #        #        #     #     #  #              #  #  #  #  #     #     #     #  #  #  #        #  #     #  #  #
####  #######  #######  #  #  ####  ##########  #  #  ###################  ####  #  ####  #######  #  #  #######  #######  #  #  #  ##########  #  #  #
#     #        #     #     #     #     #     #  #  #     #              #     #  #     #  #     #  #  #  #        #        #  #  #        #           #
#  #  ####  #  #  #######  #  ####  ####  #  #######  #######  ####  #  #######  ##########  ####  ################  #  #######  #  #############  #  #
#  #        #     #  #        #        #  #  #  #                 #  #  #     #        #              #     #        #  #        #  #  #     #     #  #
####  ####  ####  #  #  ####  #  ####  #  #  #  ####  #  #  #  #  #  ####  ####  ####  #######  ####  #  ##########  #  #  ##########  ####  #  #######
#  #     #     #           #  #     #  #  #           #  #  #  #  #  #           #              #                 #  #  #  #           #           #  #
#  #######  ##########  ####  #######  #######  #########################  #######  ####  ################  #  ####  #  ##########  ################  #
#     #     #  #        #           #  #  #           #     #     #              #  #           #  #        #     #  #        #  #           #        #
####  #######  #  #  #  #  #  #######  #  #  #######  #  #######  ####  ##########  #  ####  #  #  ####  ####  ##########  ####  #  ##########  ####  #
#     #     #     #  #  #  #           #  #     #  #  #           #  #  #  #        #  #     #        #     #  #           #  #  #  #  #     #  #     #
#  #  ####  #  #  #######  ##########  #  #######  #  #######  ####  #  #  ################  #  ##########  #######  #######  #  #  #  #  #  #  #  ####
#  #  #  #     #        #     #        #  #  #  #                          #     #           #  #     #  #     #     #     #              #     #     #
#  ####  ####  #  #######  #  ####  ####  #  #  #  #######  ##########  #  #  ####  #  #######  ####  #  ####  ####  #  ####  ################  #######
#           #  #     #  #  #     #  #  #  #           #  #     #     #  #  #        #  #                 #     #        #        #        #     #     #
#  ###################  #######  ####  #  #  #  ####  #  ####  #  #######  #  #  ####  #  ####  ##########  #  ####  #  #  #######  #  ##########  ####
#        #     #     #        #     #  #  #  #     #        #  #        #  #  #  #     #  #  #     #  #  #  #     #  #              #  #     #        #
#######  #  #######  #  ##########  #  #  ##########  #######  #  ####  #  #######  ####  #  #######  #  ####  ##########  #  ##########  ##########  #
#     #                                   #        #        #        #  #  #           #        #     #  #  #  #  #        #        #  #        #     #
#  #  ##########  ################  ####  #  ##########  #  #######  ##########  #  #######  #  #  #  #  #  ####  #  ####  #  #  #  #  #  ####  ####  #
#  #  #                          #     #  #           #  #     #  #        #  #  #        #  #     #        #     #     #  #  #  #     #  #  #        #
#  #  ####  #  ##########  #######  ##########  #  ####  #######  ####  #  #  #######  #######  #  #  ####  ####  ####  #######  ####  #  #  #  #######
#  #     #  #  #                 #  #  #        #  #  #     #  #        #           #        #  #  #     #  #     #  #     #        #     #     #     #
####  #############  ####  #######  #  ####  ####  #  #######  ####  ####  ####  #  ####  #  #######  #######  ####  #  ####  #######  #  ####  ####  #
#     #  #     #        #  #  #     #           #  #  #              #     #  #  #     #  #     #  #  #                    #        #  #  #  #     #  #
#  ####  #  ####  #######  #  #######  #############  ####  ####  #  #  ####  #  ####  #  ####  #  #######  #  #  #  #######  #  #  ####  #  ####  #  #
#        #     #     #        #        #              #  #     #  #  #     #     #     #  #  #     #        #  #  #  #     #  #  #  #  #  #           #
#  ##########  #  ##########  #  #  ################  #  #  #  ##########  ##########  ####  #  #  #######  ####  #######  ##########  #  ####  #######
#     #     #     #              #     #        #  #  #  #  #           #        #           #  #     #     #  #  #                 #     #  #     #  #
#  #  #  #  ####  #  ####  #  #  #  ####  #  ####  #  #  ####  #######  #  ####  #######  #  #  ####  ####  #  ####  #######  #######  #  #  #  ####  #
#  #  #  #  #  #  #     #  #  #  #     #  #  #        #     #     #  #  #  #     #  #     #  #     #              #  #  #     #  #  #  #  #     #  #  #
####  #  #  #  ##########  ##########  #  ##########  #  ##########  ##########  #  #######  #######  ####  #######  #  #  ####  #  ####  #  ####  #  #
#        #                       #  #        #        #  #                             #        #        #     #        #  #           #  #           #
#  #######  #  ####  #  #######  #  #  ####  #  ####  #  ####  #  ####  ##########  ####  ####  ####  ####  ####  #######  #  ####  #######  ####  #  #
#  #        #     #  #     #     #        #        #  #        #     #     #           #  #        #     #              #  #  #                 #  #   
####################################################################################################################################################   