   ########################################################################################
   #  #  #           #              #                 #        #                 #  #     #
#  #  #  ####  ####  #  ####  ####  ####  #  ####  ####  #############  #  ####  #  #  #  #
#     #     #  #           #     #        #  #     #                    #  #     #     #  #
####  #  #  ####  #  ################  #######  ####  ####  #  #  ####  ##########  #  ####
#        #        #     #     #  #     #  #  #        #     #  #  #        #     #  #     #
#######  #  ##########  #  #  #  #  ####  #  #  ####  ####  ####  ####  #  ####  #  ####  #
#        #     #           #     #        #        #     #     #  #     #           #  #  #
####  #  ####  #  ####  ####  ####  ####  ####  ####  #######  #  ####  ##########  #  #  #
#     #     #  #  #     #     #        #  #  #  #        #     #  #  #  #        #  #     #
#  #  ####  #  #  #############  ####  ####  #  #  ################  ####  ####  ####  #  #
#  #  #  #  #  #  #  #  #     #     #  #        #  #  #           #     #  #  #        #  #
#  ####  #  ####  #  #  #  #########################  ####  #######  #  ####  ####  ####  #
#  #  #  #  #     #     #                 #                       #  #  #           #     #
####  #  #  #######  ####  #######  ##########  ####  #  #######  #  ####  ####  #######  #
#     #  #  #  #           #  #        #  #  #     #  #     #        #        #     #     #
####  #  ####  #######  ####  ####  #  #  #  ################  #######  #  ####  #######  #
#  #                 #     #     #  #     #        #  #           #     #  #     #        #
#  #  ##########  #  #  ####  ####  #  #  #  #  ####  ####  ####  #  #  ################  #
#        #        #           #     #  #     #     #        #  #  #  #     #     #  #     #
##########  #  #  ####  ####  ####  #  #  #  ####  ####  ####  #  #  #######  #  #  ####  #
#        #  #  #  #  #     #  #     #  #  #  #        #  #  #  #           #  #     #     #
#  #  #######  ####  #  #  #######  #######  #############  #  #  ####  #  ####  #  #  ####
#  #  #           #     #     #        #  #  #  #  #        #  #     #  #     #  #     #  #
#  #######  ####  ####  ####  #  #######  #  #  #  #  #######  ####  ####  #############  #
#     #     #        #  #  #  #  #     #  #     #  #     #           #                 #  #
####  ####  #############  ####  #  #  #  #######  #  #  #  #  #########################  #
#           #  #  #     #        #  #           #     #     #  #     #        #     #  #  #
#  ####  ####  #  #  ####  ##########  ##########  ####  #######  ##########  #  ####  #  #
#  #  #              #  #  #           #  #     #     #        #              #           #
####  #  ####  #  #  #  ####  #######  #  ####  #  #######  #######  #  #  #  ####  #  #  #
#        #  #  #  #  #              #              #     #           #  #  #        #  #  #
####  #  #  #  #######  #############  #  ####  #  #  #############  ####  #######  #######
#     #     #     #     #  #     #     #  #     #     #  #     #        #  #     #        #
#######  ####  #  #  ####  ####  #  ####  ##########  #  #  #############  ####  #  #######
#     #     #  #                 #  #  #  #     #           #  #        #     #     #  #  #
#  ###################  ####  #  ####  #  ####  ####  #######  ####  #############  #  #  #
#        #     #        #     #  #        #  #     #     #  #  #        #     #  #     #  #
#  ####  #  ##########  #######  ####  #  #  #  #######  #  #  #  #  ####  ####  #  ####  #
#  #  #  #              #  #  #  #  #  #              #     #     #     #  #     #        #
#  #  #  #  #  ####  #  #  #  ####  ####  #############  #######  #  #  #  #  ##########  #
#     #     #     #  #  #        #     #           #  #     #     #  #           #     #  #
####  ################  #######  ####  #  ####  ####  ####  ################  #  ####  #  #
#  #  #  #     #     #           #        #  #  #     #           #     #     #  #     #  #
#  #  #  ####  #  #######  #  #######  ####  #######  #######  #######  #  #  ####  ####  #
#                    #     #  #     #  #           #  #  #  #  #        #  #  #           #
####  ####  ####  #############  ####  ##########  #  #  #  ####  ##########  #  ##########
#  #  #     #        #     #     #  #  #  #           #  #  #  #        #     #        #  #
#  #######  #######  #  #  ####  #  #  #  ####  ####  #  #  #  ####  ####  #  ####  #  #  #
#        #        #  #  #  #  #        #        #           #  #        #  #  #  #  #  #  #
#######  #######  ####  ####  #  #  #  #######  #######  ####  #######  #  ####  #  ####  #
#                 #  #     #     #  #  #     #  #     #  #     #     #  #              #  #
#  #######  ####  #  #  ####  #######  #  ####  #  ####  #  #  #  ####  #######  #######  #
#     #     #              #  #              #  #           #        #     #        #  #  #
#  ####  ##########  ####  #######  ################  ####  #  #######  #  ####  #  #  #  #
#     #  #  #  #        #        #              #        #  #           #     #  #        #
####  #  #  #  ##########  #  ####  ################  #  #######  ####  #######  #  #  #  #
#  #  #              #     #     #     #  #  #     #  #     #     #     #     #  #  #  #  #
#  ##########  ##########  #  #  ####  #  #  ####  #  #  ####  #  #  #  #  ####  #######  #
#                 #        #  #  #                    #  #     #  #  #  #        #         
########################################################################################   