###########################################################################################
         #  #     #              #           #              #  #  #        #  #  #        #
#  #######  #  #  ####  #  #######  #  #  #  ##########  ####  #  ####  #  #  #  #  ####  #
#        #  #  #  #     #     #     #  #  #           #     #  #  #     #              #  #
#  #######  #  ##########  #  #######  #  #  ####  #######  #  #  ##########  #  ##########
#        #           #     #  #        #  #  #  #           #  #              #     #     #
#  ####  ##########  #  ####  #  ####  #  ####  ####  #######  #  ####  #######  #  #  #  #
#  #        #  #  #     #  #        #  #     #        #           #        #     #  #  #  #
#######  #  #  #  ####  #  #  #############  #  #  #  #  #######  ####  ####  ##########  #
#     #  #        #     #     #     #  #  #  #  #  #     #     #     #     #        #     #
####  #  ####  #############  #  ####  #  ##########  ####  ####  #  ####  ####  #  ####  #
#     #  #     #        #           #           #  #     #  #  #  #  #     #     #  #     #
#  #  #######  #  #  ##########  ####  ####  ####  ####  #  #  #######  ####  ####  ####  #
#  #  #  #        #  #              #     #  #  #  #           #     #  #        #     #  #
####  #  #  #######  #  #  #######  #  #  #  #  #  ####  ##########  #  ####  ####  #  #  #
#     #        #  #  #  #  #  #        #  #        #  #     #        #     #     #  #  #  #
####  ##########  #  #######  ####  ####  #######  #  #  ##########  #  ####  #  ####  #  #
#           #           #     #  #  #  #  #        #     #     #        #     #  #        #
#  #  ##########  ##########  #  #  #  ####  #######  ####  #  #  #  #  #  #############  #
#  #     #  #  #        #     #  #  #     #  #     #        #  #  #  #  #        #  #     #
#  #  ####  #  #  ##########  #  #######  ####  #######  #  #############  ####  #  ####  #
#  #     #  #           #     #  #  #  #  #              #  #        #     #        #  #  #
#  ####  #  #  #  #  ####  ####  #  #  #  #############  #######  ####  #  #  #######  #  #
#     #        #  #  #  #  #  #     #     #        #  #        #        #  #        #  #  #
#  #  ####  ##########  #  #  #  #######  #  ####  #  #  ################  #  #  ####  ####
#  #  #                                   #     #     #  #  #        #     #  #           #
#  ################  ###################  ####  #  #######  ####  ####  #############  ####
#  #     #     #        #  #              #     #     #  #        #        #     #     #  #
#######  #  #######  ####  ##########  #  #  ####  #  #  #  #######  #  ####  ####  ####  #
#  #              #     #           #  #  #     #  #        #        #  #     #     #     #
#  #############  #  #######  #  ####  ####  ####  ####  #############  ####  #######  ####
#     #     #              #  #  #     #     #  #     #  #           #  #  #     #  #     #
#  ####  #  #  ##########  #  #  ####  #  ####  #  ####  ####  #######  #  ####  #  #  #  #
#        #        #  #     #  #  #        #        #     #        #        #           #  #
#  #  #######  #  #  ##########  ####  #############  ####  ####  #  #######  #######  ####
#  #  #  #     #  #              #           #  #        #     #              #  #  #  #  #
#  #  #  ####  #######  #  #######  ##########  #######  #  ####  ####  #  ####  #  ####  #
#  #        #     #     #        #              #              #  #     #  #  #     #     #
#  #  #  ####  ####  #  #######  #######  #  #  ################  #######  #  ####  #  #  #
#  #  #  #     #     #  #     #  #  #     #  #     #     #  #        #        #        #  #
###################  #######  #  #  ####  #  #######  #  #  ####  #  ####  ####  #  ####  #
#  #     #        #     #        #        #           #  #        #  #  #     #  #  #     #
#  #  ####  #  #  #  #  #######  ####  #  #  #  #  ####  ##########  #  #######  #  ####  #
#     #     #  #  #  #        #     #  #  #  #  #  #        #           #  #  #  #     #  #
####  #  ####  ####  #######  #  #  ####  #  ##########  #######  #######  #  #  #  ####  #
#     #     #     #     #  #  #  #        #  #  #  #     #     #     #           #  #     #
#  ####  ##########  ####  #############  ####  #  #######  #  ####  #  #  ####  #  ####  #
#  #  #        #                    #     #              #  #  #  #  #  #  #     #  #  #  #
#  #  ####  #######  #  ####  #  #######  #######  ####  #  #  #  #  ##########  ####  #  #
#     #  #     #  #  #     #  #     #        #     #  #     #  #     #              #     #
####  #  #  #  #  ##########  ##########  #  ####  #  #############  #######  ##########  #
#        #  #     #           #     #  #  #  #        #     #     #                 #  #  #
#######  #  #######  #######  ####  #  ####  #  #######  #######  #  #  #  #  ####  #  #  #
#  #           #           #        #        #           #  #     #  #  #  #     #  #     #
#  ##########  ####  ####  ##########  #######  ####  ####  #  #  #  ######################
#  #                 #        #              #  #  #        #  #                    #     #
#  #  #  ##########  #  ################  #######  ####  ##########  #######  #  #  #  ####
#     #     #  #     #     #     #  #     #              #  #           #  #  #  #  #     #
#  #  ####  #  #  ##########  ####  #  ####  #############  ####  #  ####  #######  #  #  #
#  #  #     #                    #                       #        #     #              #   
###########################################################################################
