+--+--+--+--+
|           |
+--+--+  +--+
|     |     |
+  +  +  +  +
|  |  |  |  |
+  +--+  +  +
|        |  |
+--+--+--+--+