#############################################################
      #     #     #  #     #  #        #  #  #     #     #  #
#  #  #  #######  #  #  ####  ####  ####  #  #  ####  #  #  #
#  #        #           #     #     #                 #  #  #
#  #######  ##########  ####  #  #  #  ####  #######  #  #  #
#     #        #     #  #        #  #  #  #  #        #  #  #
####  #  ##########  #  #  ##########  #  #  ####  #  #  #  #
#  #  #           #     #  #           #  #  #  #  #  #     #
#  #  ####  ####  #  ####  #  #  ####  #  #  #  #  ####  #  #
#     #     #              #  #     #  #     #     #     #  #
#  #  #  ################  ####  #######  ################  #
#  #  #  #  #     #        #        #        #  #           #
#  ####  #  ####  ####  ####  #######  #######  ####  #######
#  #     #  #  #  #  #     #     #        #  #        #     #
####  #  #  #  #  #  #  #  ####  ##########  #  ####  ####  #
#     #        #  #  #  #     #     #        #     #        #
#######  #######  #  #############  #  ###################  #
#                          #           #           #  #     #
#############  #  #######  ####  #  ####  #  ####  #  #  ####
#     #        #        #     #  #     #  #  #  #     #     #
#  ####  #  #  ##########  ####  #############  #  ####  ####
#        #  #     #        #     #                 #        #
####  #  #######  #######  ####  #######  ##########  #######
#  #  #     #  #     #           #     #        #           #
#  #  #  ####  #  ##########  ####  #  #  #  #############  #
#     #     #     #                 #  #  #     #  #        #
#  #  ####  #  ####  #  #  ##########  #######  #  #  #  ####
#  #  #     #  #  #  #  #        #     #  #     #     #     #
#  #######  #  #  ##########  ##########  ####  #######  #  #
#  #        #     #  #                          #        #  #
#  ####  #  ####  #  #  #  ##########  ####  #######  #######
#  #     #  #        #  #        #  #     #        #        #
#######  #  #######  ####  #######  ####  ##########  #  #  #
#  #  #  #  #           #        #     #           #  #  #  #
#  #  #  #  ##########  #  #  #  #  ####  ################  #
#  #     #     #        #  #  #        #  #  #  #        #  #
#  ####  #  ##########  ####  #  #  #######  #  #  #  ####  #
#        #  #        #  #     #  #  #     #  #     #  #  #  #
##########  #######  ####  #######  ####  #  #  #  #  #  #  #
#                    #        #     #           #  #         
#############################################################